111111111111111111111111111111111111111111
1E10000000C0000000100C000000000000C001V001
101111111111101100100000000000000000010101
101000000000000000100000000000000000010101
101000000000000000100000000000000000010101
101000001000000000100000000000000000010101
101000000000000000100000000000000000010101
101111110101101111100000000000000000010101
10100000000000000H100000000000000000010101
1010C11101111V11111000000000000000000001C1
1010000000H0000000100000000000000000010101
10111111V11111100010000000000000000001C101
101H00000000000000100000000000000000010101
1P0000000C00000000000000111111111H000000C1
111111111111111111111111111111111111111111