11111111111111111111111
1C000000000000100000001
100000000V000000000C001
1101110000111100C000001
1E0000H0001111000000001
1111111100011100H000001
100000000000010000000P1
10C0000000000100000H001
1101110V00111100000C001
100000H0000C0000000H001
11111111111111111111111