11111111
1PC000E1
100000C1
11111111